111111
1E0001
101001
1000C1
100001
1P0001
111111