111111111111111
100000C100001C1
100100010101001
100100000100001
1000C1111101101
1P0011E00000C01
111111111111111