111111111111111111111111111111
100C00000001000000E0001000C001
1001000111110C0000000010000001
10010000C001000C00000010001001
100100010001000000100010C01101
10C1C001000100111110C010001001
100100C100010000001000100010C1
1001000100010C0100100010001001
100100011001010100101010101001
100101011P010101001010101C1001
100101011000010100101000101001
1C01010110110010100101000101001
10010101100001010C101000100001
1001C000100C010100001011100C01
100100001000010100001000100001
10C100C0100001010C0010C0100101
10000000100C010000001000100101
111111111111111111111111111111