11111111111111111111111111111111111111
1E0000000000000C00000C0000000000001111
10100101001000001010010000000101001111
10100100101010100010010000000101001111
1P0000000C00C0000000000000000000C01111
11111111111111111111111111111111111111