111111
1E0001
100001
1000C1
100000
1P0001
111111