111111
1E0001
10Z001
1000C1
100001
1P0001
111111