111111
1E0001
100111
1001C1
100111
1P0001
111111