111111
1E1001
111001
1000C1
100001
1P0001
111111